
F 193,154,107
C 245,245,220

NO ./assets/cafe_south.png
SO ./assets/cafe_south.png
WE ./assets/cafe_west.png
EA ./assets/cafe_west.png

     1111111111111
11111100000001
1000000000001
1000000000101
100000W000001
1000000000001
1000000000001
1000000000001
1000000000001
101111111111
101
111
