
F 0, 0, 15
C 255, 253, 208

EA ./assets/chopin/chopin_east.png
NO ./assets/chopin/chopin_north.png
SO ./assets/chopin/chopin_south.png
WE ./assets/chopin/chopin_west.png

1111111111111111111111
1000000E00000000000001
1000100000000000000001
1000000001111111100001
1000000001      111111
1000100001
1000000001
1000000001
1000100001
1000000001
1000000001      111111
1000000001111111100001
1000100010000000000001
1000000000000000000001
1111111111111111111111