
F 193,154,107
C 245,245,220

NO ./assets/chopin/chopin_north.png
SO ./assets/chopin/chopin_south.png
WE ./assets/chopin/chopin_west.png
EA ./assets/chopin/chopin_east.png

1111111111111111111111
1000000000000000000001
1000100000000000000001
1000000001111111100001
1000000001      111111
1000100001
1000000001
1000000001
1000100001
1000000001
100000N001      111111
1000000001111111100001
1000100010000000000001
1000000000000000000001
1111111111111111111111