F 0,0,255
C 25,25,112

NO ./assets/sea/dolphins.png
SO ./assets/sea/starfish.png
WE ./assets/sea/turtle.png
EA ./assets/sea/whale.png

111111111111111111
11100000000000111111
  111111101100000001
  110111111111011111
111101111111110111
110000001101010111
1000000N00000000111111
1000000000000000100001
1100000111010100001111
111101111110101101
111111111111111111