F 0,0,255
C 25,25,112

NO ./assets/sea/dolphins.png
SO ./assets/sea/starfish.png
WE ./assets/sea/turtle.png
EA ./assets/sea/whale.png

111111111111111111111111
111000000001111111111111
11111111101100000000011111111111
11110111111111011100000010001
11110111111111011101010010001
11000000110101011100000000001
10000000000000001100000010001
10000000000000001101010010001
110000011101010111110111100111
1111011111101011011111010001
1111111111111111111111111111
